%%%%%%%%
%P . . %
% .% . %
% .% G %
% .% . %
% . . G%
%%%%%%%%
