%%%%%%%%%%%%%%%%%%%%
%o...%...GG...%....%
%.%%.%.%%%%%%.%.%%.%
%.%.............G%.%
%.%.%%.%%  %%.%%.%.%
%......%G  G%......%
%.%.%%.%%%%%%.%%.%.%
%.%..............%.%
%.%%.%.%%%%%%.%.%%.%
%....%...P....%...o%
%%%%%%%%%%%%%%%%%%%%
