%%%%%%%
% P . %
% %%% %
% %.  %
% %%G %
%. G  %
%%%%%%%
