%%%%%%%%%%%%%%%%%%%%
%..G...%G  G%......%
%.%%...%%  %%.G.%%.%
%.%o.%....G...%.o%.%
%.%%.%.%%%%%%.%.%%.%
%........P.........%
%%%%%%%%%%%%%%%%%%%%
